

NO ./Assets/Textures/wall_5.xpm
SO ./Assets/Textures/wall_5.xpm
WE ./Assets/Textures/wall_5.xpm
EA ./Assets/Textures/wall_5.xpm


F 42,42,42
C 72,61,139

11111111111111111111111
100000000000010001000011
101111111010010001111011
1000000000100100010000111111111
111110000000010000000011
100000011111111100000001
100000000000000000000001
100111110000100000000001
111000000000000000111111
110000000000111100011111
111111111100111111111111
100000000000000000000001
101111111111111111111101
111111111111111111111111
