111111111111111111111111
100P00000000010001000011
100000000010010001000011
111110000000010000000011
100000000000010000000001
100000011111111100000001
100000000000000000000001
100111110000010000000001
111000000000000000111111
110000000000000000011111
111111111100111111111111
100000000000000000000001
100000000000000000000001
111111111111111111111111