NO ./path_to_the_north_texture
SO ./path_to_the_south_texture
WE ./path_to_the_west_texture
EA ./path_to_the_east_texture


F 255,255,255
C 50,30,1

111111111111111111111111
100000000000010001000011
101111111010010001111011
1000000000100100010000111111111
111110000000010000000011
100000011111111100000001
100000000000000000000001
1001111100N0010000000001
111000000000000000111111
110000000000111100011111
111111111100111111111111
100000000000000000000001
101111111111111111111101
111111111111111111111111
