NO ./Assets/Textures/wall_1.xpm
SO ./Assets/Textures/wall_1.xpm
WE ./Assets/Textures/wall_1.xpm
EA ./Assets/Textures/wall_1.xpm

F 255,255,255
C 42,42,42


111111111111111111111111
100000000000000000000001
100000N00000000000000001
100000000010000000000001
100000000111000000000001
100000000000000000000001
100000000010000000000001
100000000000100000000001
100000100000000000000001
100000010000000000000001
100000100000000000000001
100000000000000000000001
111111111111111111111111
