NO ./Assets/Textures/walls.xpm
SO ./path_to_the_south_texture
WE ./path_to_the_west_texture
EA ./path_to_the_east_texture


F 255,255,255
C 42,42,42


1111111111111111111111111
1N00000000000010000000001
1011111111111011111111101
1010000001000000000000101
1110111111111011111100101
1000100010000010000000101
1011101010111010111111101
1000001000100010000000001
1111111111011111111111101
1000000010000000000000101
1011111111111011111110101
1000000000010010000010001
1011111101111010111011111
1000000000000000000000001
1111111111111111111111111
