NO ./Assets/Textures/eagle_wolf.xpm
SO ./Assets/Textures/bluestone_wolf.xpm
WE ./Assets/Textures/mossy_wolf.xpm
EA ./Assets/Textures/greystone_wolf.xpm


F 56,56,56
C 112,112,11

111111111111111111111111
111110000000010001000011
1011101110110D0001111011
100000000010010001000011111111111
111110000000100000000101     1111
100000011101111100001001  111   1
1000000000000001000000001 1     1
1000001100000000000000011       1
1110000011D1101000111111111111111
110000001000000000011111    1   1
111111111000000001111111    1   1
100000000000000W0D000001    1   1
1000000000000000010000011111111 1
111111111D1111D11111111111111111
10000000000000000000000001      1
10000000000000000000000001      1
111111111111111111111111111111111