NO ./Assets/Textures/bookshelf.xpm
SO ./Assets/Textures/wall_2.xpm
WE ./Assets/Textures/wall_2.xpm
EA ./Assets/Textures/wall_2.xpm


F 255,255,255
C 42,42,0

1111111111111111111111111
1000000010101000100000001
10000000101D1000100000001
10000000D0000000000000001
1000000010000000100000001
11111111100N0000111111111
1000000010000000100000001
1000000010000000100000001
10000000D0000000D00000001
1000000010000000100000001
111111111000000011111D111
1000000010000000100000001
1000000010000000100000001
10000001D0000010000000001
1000000010000000100000001
1111111111111111111111111
