NO ./Assets/Textures/eagle_wolf.xpm
SO ./Assets/Textures/bluestone_wolf.xpm
WE ./Assets/Textures/mossy_wolf.xpm
EA ./Assets/Textures/greystone_wolf.xpm


F 230, 10 , 0
C 225,30,2



11111
10001
10N01
10000
11111
