NO ./Assets/Textures/eagle_wolf.xpm
SO ./Assets/Textures/bluestone_wolf.xpm
WE ./Assets/Textures/mossy_wolf.xpm
EA ./Assets/Textures/greystone_wolf.xpm


F 56,56,56
C 112,112,11

111111111111111111111111
111110000000010001000011
101111111010010001111011
100000000010010001000011111111111
111110000000100000000101     1111
100000011101111100000001  111   1
1000000000000001000000001 1     1
1001111100000000000000011       1
1110000000W0001000111111111111111
110000000000111100011111    1   1
1111111111D1111111111111    1   1
100000000000000000000001    1   1
1000000000000000000000011111111 1
1111111111D1111111111111111111111
10000D00000000000000000001      1
10000100000000000000000001      1
111111111111111111111111111111111