NO ./path_to_the_north_texture
SO ./path_to_the_south_texture
WE ./path_to_the_west_texture
EA ./path_to_the_east_texture


F 220,100,0
C 225,30,0

11111111111111111111111
1N000000000000000000001
10000N11D11100000010001
100000000001000000D0001
10000000000100000010001
10000111111111111110001
10000D00000100000000001
10000100000100000000001
10000000000111D11110001
10000000000000000000001
11111111111111111111111