NO ./Assets/Textures/wall_1.xpm
SO ./Assets/Textures/wall_1.xpm
WE ./Assets/Textures/wall_1.xpm
EA ./Assets/Textures/wall_1.xpm

F 255,255,255
C 42,42,42


111111111111111111111111
10000000000S000000000001
100000111000000111000001
100000001000000100000001
100000001000000100000001
100000010000000010000001
100000100000000001000001
100001000000000000100001
100001000000000000100001
100000100000000001000001
100000011000000110000001
100000001000000100000001
100000001000000100000001
100000111000000111000001
100000000000000000000001
111111111111111111111111
