NO ./Assets/Textures/eagle_wolf.xpm
SO ./Assets/Textures/bluestone_wolf.xpm
WE ./Assets/Textures/mossy_wolf.xpm
EA ./Assets/Textures/greystone_wolf.xpm


F 56,56,56
C 112,112,11

111111111111111111111111
111110000000010001000011
101110111011000001111011
100000000010010001000011
111110000000100000000101
100000011101111100001001
100000000000000100000001
100000110000000000000001
111000001101101000111111
110000001000000000011111
111111111000000001111111
100000000000000W00000001
100000000000000001000001
111111111111111111111111