NO ./Assets/Textures/eagle_wolf.xpm
SO ./Assets/Textures/bluestone_wolf.xpm
WE ./Assets/Textures/mossy_wolf.xpm
EA ./Assets/Textures/greystone_wolf.xpm


F 56,56,56
C 112,112,11

111111111111111111111111111111
100000000000000S00000000000001
1011D1110000000000000011D11101
100100001000000000000100001001
100010000100000000001000010001
100001000010000000010000100001
100000100001000000100001000000
100000010000100001000010000001
100000100001000000100001000001
100001000010000000010000100001
100010000100000000001000010001
100100001000000000000100001001
1011D1110000000000000011D11101
100000000000000000000000000001
111111111111111111111111111111