11111111111111
1P000000000001
10000000100001
10000000000001
10001000000001
10000000001001
10000000000001
11111111111111