11111111111111111111111
10000000000000000000001
10000P11111100000010001
10000000000100000010001
10000000000100000010001
10000111111111111110001
10000100000100000000001
10000100000100000000001
10000000000111111110001
10000000000000000000001
11111111111111111111111

