
NO ./Assets/Textures/eagle_wolf.xpm
SO ./Assets/Textures/bluestone_wolf.xpm
WE ./Assets/Textures/mossy_wolf.xpm
EA ./Assets/Textures/greystone_wolf.xpm


F 56,56,56
C 112,112,11


        1111111111111111111111111111111111111111111111111111111111111111111111111111111111111111111111111111111111111111111111111111111111111111111111
        1000000000110000000000001
        1011000001110000000000001
        1001000000000000000000001
111111111011000001110000000000001
100000000011000001110111111111111
111101111111110111000000100011111111111111111111111111
11110111111111011101010010001
1100000011010101110000001000111111111111111111111
100000000000000010000000D0001
10000000000000001101010010001
11000001110101011111011110N0111111111111111
11110111 1110101 101111010001
11111111 1111111 11111111111111111111111111111111111