
NO ./Assets/Textures/eagle_wolf.xpm
SO ./Assets/Textures/bluestone_wolf.xpm
WE ./Assets/Textures/mossy_wolf.xpm
EA ./Assets/Textures/greystone_wolf.xpm


F 56,56,56
C 112,112,11


        111111111111111111111111111
        100000000011000000000000111
        10110000011100000000000011
        10010000000000000000000011
1111111110110000011100000000000011
10000000001100000111011111D1111111
1111011111111101110000001000111111
11110111111111011101010010001
110000001101010111000000100011111111
100000000000000010000010DW001
10000000000000001101010010001
11000001110101011111011110001111111
11110111 1110101 101111010001
11111111 1111111 111111111111111111