

NO ./Assets/Textures/eagle_wolf.xpm
SO ./Assets/Textures/eagle_wolf.xpm
WE ./Assets/Textures/eagle_wolf.xpm
EA ./Assets/Textures/eagle_wolf.xpm


F 42,42,42
C 72,61,139

111111111111111111111111
111110000000010001000011
101111111010010001111011
1000000000100100010000111111111
111110000000010000000011
100000011101111100000001
1000000000E0001000000001
100111110000000000000001
111000000000001000111111
110000000000111100011111
1111111111D1111111111111
100000000000000000000001
100000000000000000000001
111111111111111111111111


